35
35
###################################
#..@.....#.&&..@#....#$.........@##
#.....#....&&#.@#.#.$####@.####.#@#
#@.^.@#..#.&&#....#.##.....#@.....#
#.....#..#.&&#.####....#.#.#....#.#
#..@.......&&..#$...@###.#.#$^..#.#
#.###.@.###&&####.#...#$.####$.@#.#
#..........&&.....#.#.####.$#####.#
#.....#.@.@&&#$####.#$......#.....#
##.##.#....&&###@@@.###.##.####.@.#
#.....#.@.@&&&&&&&&&&&..$#.#....#.#
#&&&&&&&&&&&&&###%###&#....#$##.#.#
#&&&&&&&&&&&@%@%%%%%@&##.#.###..#$#
#.###.#.##&&%%%%%#%%%&&&&#$..#.####
#.....#.$#&#@%##%#%##%@#&###.@.#$.#
#@@.###.##&#%%#%%@%%#%%#&.........#
###.#$#.#@&#%%%%%%%%%%%#&@###.###.#
#...#...#@&%%##@%^%@##%%&@#...#...#
#.###.###@&#%%%%%%%%%%%#&@#.#$#.###
#.........&#%%#%%@%%#%%#&##.###.@@#
#.$#.@.###&#@%##%#%##%@#&#$.#.....#
####.#..$#&&&&%%%#%%%%%&&##.#.###.#
#$#..###.#.##&@%%%%%@%@&&&&&&&&&&&#
#.#.##$#...@#&###%###&&&&&&&&&&&&&#
#.#....#.#$..&&&&&&&&&&&@.@.#..@..#
#.@.####.##.###.@@@###&&....#.##.##
#.....#......$#.####$#&&@.@.#.....#
#.#####$.####.#.#.....&&..........#
#.#@.$####.$#...#.####&&###.@.###.#
#.#..^$#.#.###@...$#..&&.......@..#
#.#....#.#.#....####.#&&.#..#.....#
#.....@#.....##.#....#&&.#..#@.^.@#
#@#.####.@####$.#.#@.#&&....#.....#
##@.........$#....#@..&&.#.....@..#
###################################
00000000000000000000000000000000000
02222222222669999999999999999995550
02222222222669999999999999955555550
02222222222669999999999999955555550
02222222222669999999999999955555590
02222222222669999999999999955555590
02222222222669999999999999955555590
02222222222669999999999999995555590
02222222222669999999999999999999990
02222222222669999999999999999999990
02222222222666666666669999999999990
06666666666666111111169999999999990
06666666666611111111169999999999990
09999999996611111111166669999999990
09999999996111111111111169999999990
09999999996111111111111169999999990
09999999996111111111111169999999990
09999999996111111111111169999999990
09999999996111111111111169999999990
09999999996111111111111169999999990
09999999996111111111111169999999990
09999999996666111111111669999999990
09999999999996111111111666666666660
09999999999996111111166666666666660
09999999999996666666666633333333330
09999999999999999999996633333333330
09999999999999999999996633333333330
09444449999999999999996633333333330
09444444999999999999996633333333330
09444444999999999999996633333333330
09444444999999999999996633333333330
04444444999999999999996633333333330
04444444999999999999996633333333330
04449999999999999999996633333333330
00000000000000000000000000000000000
00000000000000000000000000000000000
00000000000000000000003000000000000
00000000000000000000200000000000000
00000000000000000000000000000000000
00000000000000000000000000000000000
00000000000000002000000000005000000
00000000000000000000000300000500000
00000000000000000000000000020000000
00000000000000100000010000000000000
00000000000000000000000000000000000
00000000000000000000000010000000000
00000000000000000600000000003000000
00000000000000000000000000000000030
00000000000000080008000000100000000
00000000100000007070000000000000200
00000000000008000000080000000000000
00000200000000700000700000000000000
00000000000600000000000600000000000
00000000000000700000700000000200000
00000000000008000000080000000000000
00200000000000007070000000100000000
00000000100000080008000000000000000
03000000000000000000000000000000000
00000030000000000600000000000000000
00000000001000000000000000000000000
00000000000000000000000000000000000
00000000000001000000100000000000000
00000002000000000000000000000000000
00000500000300000000000000000000000
00000050000000000020000000000000000
00000000000000000000000000000000000
00000000000000000000000000000000000
00000000000000200000000000000000000
00000000000030000000000000000000000
00000000000000000000000000000000000